m 20 30
1+1-1-1-1-1-1-1-1-1-1-1-1-1-1-1-1-1-1-1-1-1-1+1-1-1-1-1-1-1+
1|0 0 0 0 0 0 0 0 0 0 0 0 0 0 0 0 0 0 0 0 0 3|0 0 0 0 0 0 1|
1|0 0 0 0 2P0 0 0 0 0 0 0 0 0 0 0 0 0 0 0 0O3|0 0 0 0 0 0 1|
1|0 0 0 0 2P0 0 0 0 0 0 0 0 0 0 0 0 0 0 0 0O3|0 0 0 0 0 0 1|
1|0 0 0 0 0 0 0 0 0 0 0 0 0 0 0 0 0 0 0 0 0 3|0 0 0 0 0 0 1|
1|0 0 0 0 0 0 0 0 0 0 0 0 0 0 0 0 0 0 3-3-3-3+0 0 0 0 0 0 1|
1|0 0 0 0 0 0 0 0 0 0 0 0 0 0 0 0 0 0 0 0 0 0 0 0 0 0 0 0 1|
1|0 0 0 0 0 0 0 0 0 0 0 0 0 0 0 0 0 0 0 0 0 0 0 0 0 0 0 0 1|
1|0 0 0 0 0 0 0 0 0 0 0 0 0 0 0 0 0 0 0 0 0 0 0 0 0 0 0 0 1|
1|0 0 0 0 0 0 0 0 0 0 0 0 0 0 0 0 0 0 0 0 0 0 0 0 0 0 0 0 1|
1|0 0 0 0 0 0 0 0 0 0 0 0 0 0 0 0 0 0 0 0 0 0 0 0 0 0 0 0 1|
1|0 0 0 0 0 0 0 0 0 0 0 0 0 0 0 0 0 0 0 0 0 0 0 0 0 0 0 0 1|
1|0 0 0 0 0 0 0 0 0 0 0 0 0 0 0 0 0 0 0 0 0 0 0 0 0 0 0 0 1|
1|0 0 0 0 0 0 0 0 0 0 0 0 0 0 0 0 0 0 0 0 0 0 0 0 0 0 0 0 1|
1|0 0 0 0 0 0 0 0 0 0 0 0 0 3|0 0 0 0 0 0 0 0 0 0 0 0 0 0 1|
1|0 0 0 0 0 0 0 0 0 0 0 0 0 3|0 0 0 0 0 0 0 0 0 0 0 0 0 0 1|
1|0 0 0 0 0 0 0 0 0 0 0 0 0 3|0 0 0 0 0 0 0 0 0 0 0 0 0 0 1|
1|0 0 0 0 0 0 0 0 0 0 0 0 0 3|0 0 0 0 0 0 0 0 0 0 0 0 0 0 1|
1|0 0 0 0 0 0 0 0 0 0 0 0 0 3|0 0 0 0 0 0 0 0 0 0 0 0 0 0 1|
1+1-1-1-1-1-1-1-1-1-1-1-1-1-1+1-1-1-1-1-1-1-1-1-1-1-1-1-1-1+
f
b 2 2 5 2 21
b 2 3 5 3 21

# item creation
i 1 10 5 #
i 1 2 10 %
i 2 3 10 &

# snake construction
s 10 17 s -1 -1
s 10 16 @ 10 17
s 10 15 @ 10 16
w 10 15 3 3
